1 1 10 6
1111111111
1000000001
10000S0000
1000000001
1000000001
1111D11111

2 1 10 6
1111111111
10T000T0T1
00T0T0T000
10T0T0T0T1
1000T000T1
1111111111

3 1 10 6
1111111111
1000000001
0000000000
1000000001
1000000001
1111111111

4 1 10 6
1111111111
10T000T0T1
00T0T0T000
10T0T0T0T1
1000T000T1
1111111111

5 1 10 6
1111111111
1000000001
0000000000
1000000001
1000000001
1111111111

6 1 10 6
1111111111
10T000T0T1
00T0T0T000
10T0T0T0T1
1000T000T1
1111111111

7 1 10 6
1111111111
1000000001
0000000000
1000000001
1000000001
1111111111

8 1 10 6
1111111111
10T000T0T1
00T0T0T000
10T0T0T0T1
1000T000T1
1111111111

9 1 10 6
1111111111
1000000001
0000000000
1000000001
1000000001
1111111111

10 1 10 6
1111111111
10T000T0T1
00T0T0T000
10T0T0T0T1
1000T000T1
1111111111

11 1 10 6
1111111111
1000000001
0000000000
1000000001
1000000001
1111111111

12 1 10 6
1111111111
10T000T0T1
00T0T0T000
10T0T0T0T1
1000T000T1
1111111111

13 1 10 6
1111111111
1000000001
0000000001
1000000001
10000000K1
1111111111

1 2 10 6
G
