1 1 50 50
11111111111111111111111111111111111111111111111111
1K000000TT000000T00000T00000T0000000000000T0000001
10000000000000000000000000000000000T0000000T000001
100000000000000000000T000T00000000000000T0T0000001
100000000000000T0000000000000000000000000000000001
1T000T000T00T0T0000000T0T0000000000T00000000000001
1T0000000000000T00T00TT000000000000000T00T00000001
10000000000000T00000000000000T0000000000000000TT01
10000000000000000000T000000T0T0TT000000T0000000001
1T000000000000T00T00000000T000000000000000T0000001
10000T000T0000000000000T0T0000T00T0000000000000T01
1000000T0000000000TT0000000000000000000000T00T0001
10T0000000T000000T00000000T000000T000000000T000001
1000TT000TT0000000T00000000T0000000000T00000000001
100000000000000000000T00000000000T00000000T0000001
1000000000T000T0000000000000000000T000000T00000001
1000T00T00000T0000000000T0T00000000T00000000T00001
10000T000000000000000000T000000T0T0000000000TTT001
100000000T00000000T00000000T000T000000000T00000001
1000000000000000T000000T0000000000000T00000000T0T1
10000000000000000T000000T0000000T000T0000000000001
1000000000000000000000000TT00000T00000000000000001
1000000000000000000T00T00T00000T000000000000000001
1000T0T000000000T0T000000T0000000T000000000T0T0001
100TT0000T00000000T00TT0T0000000T00000000T000000T1
100000TT0000T0000000T0000T00T000000000000000000001
1000000000000T00000000TT0000T0000000000000000T0001
100000000000000T000000000000T000000000T0T000T00001
10000000000000000000000000000000000T00000000000001
100000000000000000T000000000000000T0T000000T000001
10000000000000000000000T00000000000000000000000001
100T0000000000000000T0000000000000T00000000000T001
1000000T000000T0TT00000000T000000000000TT000000001
100T0000TT000000000000000T0000000000000000000T0001
100T000000T000000000000000000T0000000000000T000001
10000000000000000T0000000000T0T00000000000T0T00001
100TTT00000T0000000T00000000000000000T0T00000T0001
1000000000000T0T000000000T0T0T0000T0000T0000000001
10T0TT000000000000000T0000T0TT00T0T000000000000001
1000T00T0T0000000000000000000000000T000000T0000001
100000T000000T000000T00000000T0T00000000000T00T001
1T00000T000000T000000000T000000000000T0T00T0000001
1000000000000000T000000000T000T0000T00000000000001
100000000000000000000000T0T00000000000T0T000000001
1000T0000TT00T00T0000000000T0000T0T0000T0T000000T1
1000000T000000000000000000000000000000T0T0000S0001
1000000000000000T00T00T000T0T000000000000000000001
10T00T0000000000000T0000000T00T00000000000T00T00T1
1000000000000000000000000T000000000000000000000001
111111111111111111111111111111111111111111111111D1

1 2 50 50
G
