1 1 50 50
11111111111111111111111111111111111111111111111111
1KT00000T0T0000T0000000000T00T0000000T000T000T0001
10000T000000000T00000000000000T00TT000000T00000T01
10T000000000000TT0000TT000T00000000T000T00T00TT0T1
10T00T00000T0T0000T0000T00T0T00000000T0T000TT00001
100000000T0000000T00000000000000000T000TT000TT0001
100000000T000T00000000T0TTT0T0TT0000T00000T00000T1
100TT00000TT0000000T00TT0000000T0TT000000TT00000T1
1000T000000000000TT000000TT00TT00TT0TTT0000000T001
1T00000000000000000TT0000T000TT00T00000T0000000T01
10000000T0TT000000T0TT0T000T00T00000T00000000000T1
10000T00000000T000000000000000T000TT0000000TT00T01
100000000TTT000T0T00T0000T0T000000T000T000T0000001
1T0000T00T00T000000T0000000T00T000000T00000T000001
100TT000T0T00000T000000T00000TT0TT00T000T000T00001
10000000T00TT000T000TT000000000T000T00000T0000TT01
1TT0T0000000T00TTT0T00T0000000000000T00T000T0000T1
100T0T0000000000000T00TTT00T00T0000000000000000T01
1TT00TT00000T000000T00T00000000T00T000000T00000001
1000000000TT00T0TTT000T000T00000000000000000000001
10T000T00T00000T000000000TT0T00T0TT0000T00000T0001
100TT000000000T0000000T0T0000T0T000000T0T0000T0T01
100000T0TTT00T0000000000000000000000T00T0000000001
100000000000T0000000000000000000000000T00000T0TT01
1T00000T0TT000000000T000000000000000000TT0T000T001
1000000T000000000000T0T0T000T00000000TT00000T0T001
10T00000000000T0000000000T00T0T0T00000000TT0T00001
1000000000000T00T0T0T00000T0TT000000T0T000000000T1
10TTTT000000T00000000T0T000T0000000T0T0T0000000T01
100T00T00000T00000T00T00TTT0000000TT0000000000T0T1
10000TT000000000T0000000000000000T000000T000000001
1000T0000TT0000TTT0000T0T000000TT00000000000000T01
10T0000000000T0000T00000T00000000000T0T00000000001
1T0000T0000T00T00T00000000000TT00000TT000000TT00T1
100000000TT00000000000000000T0000T0000T00TTT000001
1T000T00T00T000000000000000TT00000000T00000T0000T1
1T0T0000000000000T00000T0TT0TT0T00000000000000T0T1
100000000T0000T00000T00000000T000T0000000000000001
1000000T00T00T0T0000000000T00000T0T000000000TT0T01
100000000T00000000000T000000000T000000000000000001
10000T0T00000000T0000000T0000TT00000T0T0T000TT0TT1
10T00T0TT0T0T00000T0T00T000000000T0T00000000000T01
10000T0000000000000T0000T0T00000T00000000T00T00001
1T000T00T00T0000000000T0T000000000000T0000T000T001
10000000000000000T000000000000T0T000T00T0000000001
1000TT0T0TT000000TT0000000000T0000000TT00000TS0001
1TT0000T000T0T00T0000000T000T000000000000T0000T001
100000000T00T000T00000T0000000000000T00T0000000001
100000TT00T000000000000000TTTT0000000T0T000000T001
111111111111111111111111111111111111111111111111D1

1 2 50 50
G
