1 1 20 20
11111111111111111111
1K000000000000000001
10000000000000000001
10000000000000000001
10000000000000000001
10000000000000000001
10000000000000000001
10000000000000000001
10000000000000000001
10000000000000000001
10000000000000000001
10000000000000000001
10000000000000000001
10000000000000000001
10000000000000000001
100000000000000S0001
10000000000000000001
10000000000000000001
10000000000000000001
111111111111111111D1

1 2 20 20
G
