1 1 20 20
11111111111111111111
1K00000TT00000000001
100000000000T0000001
10000T000000T0000001
1T0000000T0000000001
10000000T00000000001
1T000000000000000001
1000T00000T000000001
100000T0000000000001
10000000000000000001
100000000000T00000T1
10000000TT0000000001
100000000000000000T1
10000000000000T00001
10000000000000000001
100T0T000000000S0001
10000000000000000001
10000000000000000001
10000000000000000001
111111111111111111D1

1 2 20 20
G
