1 1 20 20
11111111111111111111
1KTT000000T000000001
1000T0T00T0T00000001
1T000T0T0T0000000TT1
100000T0000T000T00T1
1T00T00000000TT00001
10000T000000000TT001
10T00T0000T0T0000001
1T00000TT0T000000001
1TT0000TTT0000000001
1T000T00T0000T00T001
100T0000000000TT0001
10TT00T00T00T00T0T01
1000T00000T0T000T001
10000T0TT00000T00001
100000T0000T000S0001
100T0T00T0T00000T0T1
1000T00000T00TT00T01
1000000T000T000T0001
111111111111111111D1

1 2 20 20
G
