1 1 30 30
111111111111111111111111111111
1KT000T0000T0T0000000000T00001
1000000T00TT00T00T000T00000001
100000000000T0000T000000000001
100000T0T000000000000000T00001
100000T000TTT0TT00TT00T0000001
10000TT000T0T000T0000000000001
1000000000T0000000TT0000TTT001
100T00T000T0T00T000000T00T0T01
1000000T0000TTT0T0T000T0T000T1
100000000T00000T00000000000T01
1000T0T00T000T0T0T00000000T001
10TT0000000T00000000000000T0T1
10000T00000TTTT000000000T00001
1T0000T00T000000000000T0000001
1000T0000000TTT0000T000T0TTTT1
10000000000000000000TT00000001
100000000000T000T00T0000000001
1000000T0000000T0000000T000001
1000T00TT0000000T00000000T0001
10T000000T0000000000T0000000T1
10000000000TT000T0000T00T0T001
100T0T0000T00000T0TTT000000T01
1000T00000T0000T0000000000T001
1T000T00T0000T0000000000T0T001
1TT000000T000000TT0000000S00T1
10T00T000000000TT0000000000001
1000T000TT0T000000000000000001
10000T0TT00T000T000000000T0001
1111111111111111111111111111D1

1 2 30 30
G
