1 1 30 30
111111111111111111111111111111
1K000T0000T0000T0T0000000000T1
10000000T00000T0000000000T0001
1T000000000000000T000000000001
10000T00000000000000000000TT01
1000T0000T000T0T00T00000000001
1T0000T0T000000000T00000000T01
10T00T000000000000000000000001
100000000000T0T000000T000000T1
100000000000T00000000000000001
10000000000T000000T00000000001
100000000000000000000000000001
10T00000000000T000000000000001
100000000000000000T00000000001
1000000T0000000000000000000001
100T000000000000T000T000000001
100T00000000000000000000000TT1
100000000T000T0000T00000000001
100000T0000T000000000T00000001
100000000000000000000000000001
1T00T0000T00000000000T00000001
10000T000000T00T00T0T000T00001
1000000000000000000000T0000001
10000000000000T0000000000000T1
1000000000000000T0000000000001
100T0T00000T00TT000000T00S00T1
10000T000000000000T00000000001
1T0T000000000000000000000T0001
100T0T0000T0000000000000000001
1111111111111111111111111111D1

1 2 30 30
G
